J..#..#..T
##.#..#.##
...#..#...
.#.#..#...
.#.####...
...#......
##.#.##.V.
...#K.....
D..#..C...
T.V....B.R