J.#.......
..#.###T.B
D.#.......
#.#.###...
..#C..#...
T##.#.#V..
..#.#.....
.#D##.#T..
.K..S.C.V.
T.....T..R