J#........
.#.###....
.D.#D..T..
.#.#.###.S
...#...#..
T###C.#V..
.#K...#...
.#.##.#T..
....B..CV.
....T...TR