J.........
.###..T#..
.D....#...
.#.##.#T..
...#..#...
.###C.#...
.T...#V...
.#.##.#...
.K.D.BS.C.
.T..V...TR