J#........
.#.###....
.D.#...T..
.#.#.###..
...#...#..
T###C.#V..
.#....#...
.#.##.#T..
.KD.BS.CV.
....T...TR