J..#..#..T
##.#..#.##
T..#..#...
.#T#..#..T
.#.####...
...#D.C...
##.#.##.V.
...#K.....
D..#..C...
T.V....B.R