J.........
.###..T#.B
.D....#...
.#.##.#T..
...#D.#...
.###C.#...
.T...#V...
.#.##.#...
.K....S.C.
.T..V...TR