J....#....
###..#.T..
...D.#...B
.#.###.#..
.#....#C..
.T###.#...
...#..#V..
.#D##.#T..
.K..S.C.V.
T......T.R