J.#.......
..#.###T..
D.#.......
#.#.###...
..#C..#...
T##.#.#V..
..#.#.....
.#D##.#T..
.K.BS.C.V.
T.....T..R